11111311111111111111111111111111
14444444444444444444444444444441
14444444444444444444444444444443
14444444444444444444444444444441
14444444444444444444424444444441
14444444444444400444444444444441
14444444444444404400404444444441
14444444440404040000404044444441
14444444004440000400044444444441
14444444040000000000004444444441
34444444440000004440444444444441
14444444444444444444444444444441
14444444444444444444444444444441
14444444444444444444444444444441
14444444444444444444444444444441
14444444444444444444444444444441
14444444444444444444444444444441
11111111111111111113111111111111
