11111111111111111311111111111111
14444444444444444444444444444441
14444444444444444444444444444441
14411144444444444444444444111441
14414144444444444444444444141441
14411144444444444444444444111441
14444444444444444444444444444441
34444444444444444444444444444441
14444444444444424444444444444441
14444444444444444444444444444441
14444444444444444444444444444443
14444444444444444444444444444441
14411144444444444444444444111441
14414144444444444444444444141441
14411144444444444444444444111441
14444444444444444444444444444441
14444444444444444444444444444441
11111111111111311111111111111111
