11111111111111111111111311111111
14444444444444444444444444444441
34444444444444444444444444444441
14441114444444444444444441114441
14441114444444444444444441114441
14441114444444444444444441114441
14444444444444444424444444444441
14444444444444444444444444444441
14444444444444400444444444444441
14444444444444400444444444444441
14444444444444444444444444444441
14444444444444444444444444444441
14441114444444444444444441114443
14441114444444444444444441114441
14441114444444444444444441114441
14444444444444444444444444444441
14444444444444444444444444444441
11111311111111111111111111111111
