11111113111111111111111111111111
14444444444444444444444444444441
14444444444444444444444444444441
14444444444444444444444444444441
34444444444111144111144444444441
14444444444144444444144444444441
14444444444144444444144444444441
14444444444144444444144444444441
14444444444444400444444444444441
14444444444444400444444444444441
14444444444144444444144444444443
14444444444144444444142444444441
14444444444144444441144444444441
14444444444111144111144444444441
14444444444444444444444444444441
14444444444444444444444444444441
14444444444444444444444444444441
11111111311111111111111111111111
