11111111131111111111111111111111
14444444444444444444444444444441
14444444444444444444444444444441
14444144144444444444444144144441
34444144144244444444444144144441
14444144444444444444444444144441
14444144144440000004444144144441
14444144144440444404444144144441
14444444444440444404444444444441
14444444444440444404444444444441
14444444444440444404444444444443
14444144144440000004444144144441
14444144144444444444444144144441
14444144444444444444444444144441
14444144144444444444444144144441
14444144144444444444444144144441
14444444444444444444444444444441
11111111111111111111131111111111
