11111111131111111111111111111111
14444444444444444444444444444441
14444444444444444444444444444441
14444444444444444444444444424441
14444444441444111144414444444443
14444444441444444444414444444441
14444444441444444444414444444441
14444444441444144144414444444441
14444000441444144144414400044441
14444000441444144144414400044441
14444444441444144144414444444441
14444444441444444444414444444441
14444444441444444444414444444441
34444444441444111144414444444441
14444444444444444444444444444441
14444444444444444444444444444441
14444444444444444444444444444441
11111111111111111111311111111111
