11111111311111111111111111111111
10000004440000000044444444444441
10000004440000000044444444444443
10000004440000000044444444444441
10000004440000000044400000000001
10000004440000000044400000000001
10000004240000000044400000000001
10000004440000000044400000000001
10000004444414444444400000000001
14444444444444414444400000000001
34444444440000000044400000000001
14444444440000000044400000000001
10000000000000000044400000000001
10000000000000000044400000000001
10000000000000000044400000000001
10000000000000000044400000000001
10000000000000000044400000000001
11111111111111111113111111111111
