11111111131111111111111111111111
14444444444444444444444444444441
14444444444444444444444444444441
14444444444000000000044444444443
14440444444444444444444444404441
14444444444444444424444444444441
14444444444444444444444444444441
14444440444044400444044404444441
14440444444444444444444444404441
14440444444444444444444444404441
14444440444044400444044404444441
14444444444444444444444444444441
14444444444444444444444444444441
34440444444444444444444444404441
14444444444000000000044444444441
14444444444444444444444444444441
14444444444444444444444444444441
11111111111111111111111113111111
