11111111131111111111111111111111
10000444444444444444444444400001
10444444444444444444444444444401
10444444444444424444444444444401
10440004444444444444444440004401
14440444444444444444444444404441
14440444444441111114444444404443
14444440444441111114444404444441
14444444444441111114444444444441
14444444444441111114444444444441
14444440444441111114444404444441
34440444444441111114444444404441
14440444444444444444444444404441
10440004444444444444444440004401
10444444444444444444444444444401
10444444444444444444444444444401
10000444444444444444444444400001
11111111111111111111131111111111
