11111111311111111111111111111111
14444444444444444444444444444441
14444444400000000000000444444441
14424144404444444444440444144441
14444144404000000000040444144443
14444144404044444444040444144441
14444444404040000004040444444441
14444444404040444404040444444441
14444444404040400404040444444441
14444444404040400404040444444441
14444444404040444404040444444441
34444444404040000004040444444441
14444144404044444444040444144441
14444144404000000000040444144441
14444144404444444444440444144441
14444444400000000000000444444441
14444444444444444444444444444441
11111111111111111111111111111311
