11111131111111111111111111111111
14444444444444111144444444444441
14444444444444111144444444444441
14444444444444111144444444444443
14444444444444111144444444444441
14444444442444111144444444444441
14444444444444111144444444444441
14444444444444111144444444444441
14444444444444111144444444444441
14444444444444111144444444444441
14444444444444111144444444444441
14444444444444444444444444444441
14444444444444444444444444444441
14444444444444000044444444444441
34444444444444000044444444444441
14444444444444444444444444444441
14444444444444444444444444444441
11111111111111111111111113111111
