11113111111111111111111111111111
14444444444144444444444441444441
14444444444144444444444441444443
14444444444144444444444441444441
14444444444144424444444441444441
14444444444144444444444441444441
14444444444144444444444441444441
14444414444144444444144441444441
14444414444144400444144441444441
14444414444144400444144441444441
14444414444144444444144441444441
14444414444444444444144444444441
14444414444444444444144444444441
14444414444444444444144444444441
14444414444444444444144444444441
34444414444444444444144444444441
14444414444444444444144444444441
11113111111111111111111111111111
