11111111111111311111111111111111
10000000000000400000000000000001
10444444444444444444444444444401
10444444444444444444444444444401
10444444144444444444444144444401
10444444144444444444444144444401
10444444144444444444444144444401
10444444144444444444444144444443
10444444144444442444444144444401
10444444144444444444444144444401
34444444144444444444444144444401
10444444144444444444444144444401
10444444144444444444444144444401
10444444144444444444444144444401
10444444444444444444444444444401
10444444444444444444444444444401
10000000000000000000000000000001
11111111111111111311111111111111
