11111111111113111111111111111111
14444444444444444444444444444441
14444444444444444444444444444441
14444444444444444444444444444441
14444444444444444444444444444441
14444444444444444444444444444441
14444444444000000000044444444441
14444444444044444444044444444443
14444444444044424444044444444441
14444444444044444444044444444441
14444444444044444444044444444441
14444444444000000000044444444441
34444444444444444444444444444441
14444444444444444444444444444441
14444444444444444444444444444441
14444444444444444444444444444441
14444444444444444444444444444441
11111111111111111311111111111111
