11111111111111111111131111111111
14444444444444444444444444444441
14444444444444444444444444444441
14444444444444444444444444444441
34441111444444444444444411114441
14441444444444111144444444414441
14441444444444444444444444414441
14441444444424444444444444414441
14444444444444444444444444444441
14444444444444444444444444444441
14441444444444444444444444414441
14441444444444444444444444414443
14441444444444111144444444414441
14441111444444444444444411114441
14444444444444444444444444444441
14444444444444444444444444444441
14444444444444444444444444444441
11111111111111111113111111111111
