11111111111111111111113111111111
14444444444444444444444444444441
14444444444444444444444444444441
14444444444444444444444444444441
14444444444441000014444444444441
14444444444441444414444444444441
14444441444441444414444414444441
14444441444441444414444414444443
14444441444444444444444414444441
14444441444444444444444414444441
34444441444441444414444414444441
14444441444441444414444414444441
14444444444441444414444444444441
14444244444441000014444444444441
14444444444444444444444444444441
14444444444444444444444444444441
14444444444444444444444444444441
11111111311111111111111111111111
