11111111111111111111131111111111
14444444444444444444444444444441
14444444444444444444444444444441
14444444444444444444444444444441
34444444444444444444444444444443
14444444444444444444444444444441
14444444444444444444444444444441
14444444444444444444444444444441
14444444444444424444444444444441
14444444444444444444444444444441
14444444444444444444444444444441
14444444444444444444444444444441
14444444444444444444444444444441
14444444444444444444444444444441
14444444444444444444444444444441
14444444444444444444444444444441
14444444444444444444444444444441
11111111111111111111111311111111
